.............###################################################################
.............###################################################################
.............###################################################################
.............###################################################################
.............###################################################################
.............###################################################################
.............###################################################################
##.........#####################################################################
##.........#####################################################################
##.........#####################################################################
##.........#####################################################################
##.........#####################################################################
##.........#####################################################################
##.........#####################################################################
##.........#####################################################################
##.........#####################################################################
##.........#####################################################################
##.........#####################################################################
##.........#####################################################################
##.........#####################################################################
##.........#####################################################################
##.........#####################################################################
##.........#####################################################################
##.........#####################################################################
##.........#####################################################################
##.........#####################################################################
##.........#####################################################################
##.........#####################################################################
##.........#####################################################################
##.........#####################################################################
##.........#####################################################################
##.........#####################################################################
##.........#####################################################################
##.........#####################################################################
##.........#####################################################################
##.........#####################################################################
##.........#####################################################################
##.........#####################################################################
##.........#####################################################################
##.........#####################################################################
##.........#####################################################################
##.........#####################################################################
##.........#####################################################################
##.........#####################################################################
##.........#####################################################################
##.........#####################################################################
##.........#####################################################################
##.........#####################################################################
##.........#####################################################################
##.........#####################################################################
##.........#####################################################################
##.........#####################################################################
##.........#####################################################################
##.........#####################################################################
##.........#####################################################################
##.........#####################################################################
##!!!!!!!!!#####################################################################
##!!!!!!!!!#####################################################################
##!!!!!!!!!#####################################################################
##!!!!!!!!!#####################################################################
