....#....................#................######################################
....#....................#................######################################
....#....................#................######################################
....#....................#......#.........######################################
....#....................#......#.........######################################
....#....................#......#.........######################################
....#....................#......#.........######################################
....#.........#..........#......#.........######################################
....#.........#..........#......#.........######################################
....#.........#..........#......#.........######################################
....#.........#..........#......#.........######################################
....#.........#..........#......#.........######################################
....#.........#..........#......#.........######################################
....#.........#..........#......#.........######################################
....#.........#..........#......#.........######################################
....#.........#..........#......#.........######################################
....#.........#..........#......#.........######################################
....#.........#..........#......#.........######################################
....#.........#..........#......#.........######################################
....#.........#..........#......#.........######################################
....#.........#..........#......#.........######################################
....#.........#..........#......#.........######################################
....#.........#..........#......#.........######################################
....#.........#.................#.........######################################
....#.........#.................#.........######################################
..............#.................#.........######################################
..............#.................#.........######################################
#################################.........######################################
..........................................######################################
..........................................######################################
#############.....##############################################################
#############.....##############################################################
#############.....##############################################################
#############.....##############################################################
#############.....##############################################################
#############.....##############################################################
#############.....##############################################################
#############.....##############################################################
#############...................................................################
#############...................................................################
#############.....########################################......################
#############.....########################################......################
#############.....########################################......################
#############.....########################################......################
#############.....########################################......################
#############.....########################################......################
#############.....########################################......################
#############.....########################################......################
#############.....########################################......################
#############.....########################################......################
#############.....########################################......################
##########################################################......################
##########################################################......################
##########################################################......################
##########################################################......################
##########################################################......################
##########################################################......################
##########################################################!!!!!!################
##########################################################!!!!!!################
##########################################################!!!!!!################
