#################################################################################
#.............###################################################################
#.............###################################################################
#.............###################################################################
#.............###################################################################
#.............###################################################################
#.............###################################################################
#.............###################################################################
#.............###################################################################
#.............###################################################################
#.............###################################################################
#.............###################################################################
#.............###################################################################
#.............###################################################################
#.............###################################################################
#.............###################################################################
#.............###################################################################
#.............###################################################################
#.............###################################################################
#.............###################################################################
#.............###################################################################
#.............###################################################################
#.............###################################################################
#.............###################################################################
#.............###################################################################
#.............###################################################################
#.............###################################################################
#.............###################################################################
#.............###################################################################
#.............###################################################################
#.............###################################################################
#.............###################################################################
#.............###################################################################
#.............###################################################################
#.............###################################################################
#.............###################################################################
#.............###################################################################
#.............###################################################################
#.............###################################################################
#.............###################################################################
#.............###################################################################
#.............###################################################################
#.............###################################################################
#.............###################################################################
#.............###################################################################
#.............###################################################################
#.............###################################################################
#.............###################################################################
#.............###################################################################
#.............###################################################################
#.............###################################################################
#.............###################################################################
#.............###################################################################
#.............###################################################################
#.............###################################################################
#.............###################################################################
#.............###################################################################
#!!!!!!!!!!!!!###################################################################
#!!!!!!!!!!!!!###################################################################
#!!!!!!!!!!!!!###################################################################
#!!!!!!!!!!!!!###################################################################
#################################################################################
