#################################################################################
#....#....................#................######################################
#....#....................#................######################################
#....#....................#......#.........######################################
#....#....................#......#.........######################################
#....#....................#......#.........######################################
#....#....................#......#.........######################################
#....#.........#..........#......#.........######################################
#....#.........#..........#......#.........######################################
#....#.........#..........#......#.........######################################
#....#.........#..........#......#.........######################################
#....#.........#..........#......#.........######################################
#....#.........#..........#......#.........######################################
#....#.........#..........#......#.........######################################
#....#.........#..........#......#.........######################################
#....#.........#..........#......#.........######################################
#....#.........#..........#......#.........######################################
#....#.........#..........#......#.........######################################
#....#.........#..........#......#.........######################################
#....#.........#..........#......#.........######################################
#....#.........#..........#......#.........######################################
#....#.........#..........#......#.........######################################
#....#.........#..........#......#.........######################################
#....#.........#.................#.........######################################
#....#.........#.................#.........######################################
#..............#.................#.........######################################
#..............#.................#.........######################################
#..............#.................#.........######################################
##################################.........######################################
#..........................................######################################
#..........................................######################################
##############.....##############################################################
##############.....##############################################################
##############.....##############################################################
##############.....##############################################################
##############.....##############################################################
##############.....##############################################################
##############.....##############################################################
##############.....##############################################################
##############...................................................################
##############...................................................################
##############.....########################################......################
##############.....########################################......################
##############.....########################################......################
##############.....########################################......################
##############.....########################################......################
##############.....########################################......################
##############.....########################################......################
##############.....########################################......################
##############.....########################################......################
##############.....########################################......################
##############.....########################################......################
###########################################################......################
###########################################################......################
###########################################################......################
###########################################################......################
###########################################################......################
###########################################################......################
###########################################################!!!!!!################
###########################################################!!!!!!################
###########################################################!!!!!!################
